##########
#        #
#        #
#   ##   #
#        #
#        #
##########